 ####
##  ####
#      #
# ..#$ #
###  $ #
  ###@ #
    ####  