######
#   .#
# $$.#
# $@.#
######