  #####
###   ####
# .$.$@  #
#  $.$.  #
### # ####
  #   #
  #####