 ####
 #  #
##  ###
#    .#
# $$ @#
# #  .#
#######