#######
#    .#
#  $$.#
#  # @#
#######