########
#     .#
#   $$@#
#  #  .#
########