######
# @ .#
# $$ #
#  #.#
#    #
######