 ####
 #  ##
## $ #
# .$.##
# $.$ #
# .$. #
###@###
 #  #
 #  #
 #  #
 ####