#######
#     #
#    .#
#@$$$.#
#  # .#
#######