########
#     .#
#  $$ @#
#  #  .#
########