  ####
  #  #
 ##. #
 # . #
##$.$###
#@$.$  #
# $.   #
###  ###
  ####