########
#   # .#
#   $$@#
####   #
   #  .#
   #####