#######
#    .#
#@$$$.#
#   #.#
#######