  ####
 ##  ###
##     #
#  @$$.#
#   # .#
########