########
#     .#
#  $$ .#
#  #  @#
########