 #####
##  .#
# $$@#
# .  #
######