    #####
  ###@  #
  #. $ .#
  #  $ ##
 ### ###
## $  #
#     #
#.  ###
##### 