     ####
     #  #####
    ##@     #
#####   ##  #
# ..x x ## ##
#     $  x$#
##  x x    #
 ####   ##$##
    #xxx##  #
    #.      #
    #########