      ####
#######  #
#@$      #
######## #
       # #
 ####  # ###
 #  ####   #
 #         #
 # #########
 # #
 #.#
 ###