########
#     .#
# @$$$.#
#  #  .#
########