######
# @$.#
#    #
# $#.#
#    #
######