#######
#  $ .#
#  @$ #
#  #$.#
#  . ##
######  