  ####
  # .#
###  ##
# $$  #
#     #
##$# ##
 #.@.#
 #####