######
#.  .#
# $$ #
#$ # #
#@  .#
######