    #####
    #   #
    #$  #
  ###  $##
  #  $ $ #
### # ## #   #####
#   # ## ##### .*#
#   $          ..#
##### ### #@## ..#
    #     ########
    #######