####
#  ####
# .  .#
# . # #
#  $  #
##$$###
 # @#
 ####