 #####
## @.##
# $$* #
#  #. #
#     #
# $#  #
##  .##
 #####