######
#   .#
# $$@#
#  # #
#.   #
######