    #####
    #   #
    #$  #
  ###  $##
  #  $ $ #
### # ## #   #####
#   # ## ##### ..#
# $  $         ..#
##### ### #@## ..#
    #     ########
    #######