 #######
##....@##
#  $ #$ #
#  $  $ #
#  xx   #
#########