######
# @ .#
# $$ #
#  # #
##.  #
 #####