######
#   .#
# $$@#
#  # #
# .  #
######