 #####
##  .#
# $$ #
# @.##
#####