 #####
 #   #
## *$###
# *@*  #
# .*   #
##   ###
 #  ##
 ####