########
#   #  #
#     .#
# $$  @#
# #   .#
########