######
# @ .#
# $$ #
#  # #
#   .#
######