  ####
  #  #
###  ###
#  $$$ #
# ...# #
# #... #
# $$$@##
###   #
  #####