######
#   .#
# $$@#
#  #.#
######