      ####
#######  #
#@$      #
######## #
       # #
 ####  # ##
 #  ####  #
 #        #
 # ########
 # #
 #.#
 ###