    ####
#####  #
#   ..$##
# $@# $ #
##$..   #
 #  xx  #
 ########