    #####
  ###@  #
  #. $ .#
  #  $ ##
 ##x x##
## $  #
#     #
#.  ###
##### 