 #####
##@ .#
# $$.#
#    #
######