#######
#    .#
# $$#.#
# $@ .#
#     #
#######