 #######
##    .#
#   $$@#
#   # .#
########