    ####
#####  #
#   ..$##
# $@# $ #
##$..   #
 #  ##  #
 ########