########
#   # .#
#   $$+#
####   #
   #   #
   #####