######
#   .#
# $$+#
#  # #
#    #
######